#################
#...............#
########.########
#...............#
########.########
#...............#
########.########
#...............#
#################
