#################################################################################
#.....#.....#...................#...#...#.........#.......#.......#.............#
#.###.###.#.#.#####.###########.#.#.#.#.#.###.###.###.###.###.###.#######.#####.#
#.#...#...#...#.....#.......#.#.#.#.#.#.#...#...#...#.#.#...#.#.#.#.....#.#...#.#
#.#.###.#######.#####.#####.#.#.#.#.#.#.###.###.###.#.#.###.#.#.#.#.###.#.#.#.#.#
#.#.....#.....#.#.....#...#.#.....#...#.#.#.#.#.#.....#.......#.....#...#.#.#.#.#
#.#######.#.###.#.#####.#.#.#.#########.#.#.#.#.#.#############.#######.#.#.#.#.#
#.#.......#.....#.....#.#...#.#.......#.#.....#.#.#...........#.#.....#.#.#.#.#.#
#.#####.#############.#.#######.#####.#.#.#####.###.#########.#.#.###.#.###.#.#.#
#.....#.#.#.........#.#.........#.#...#.#.#.....#...#.......#.#.#...#.#.....#.#.#
#.###.#.#.#.#.#####.#.###########.#.###.#.#.###.#.#########.#.#####.#.#######.#.#
#.#.#.#.#...#.#...#.#.#.....#.....#.#.#.#.#.#...#.........#.#...#...#.....#.#...#
#.#.#.#.###.#.#.#.###.#####.#.#.###.#.#.#.#.#############.#.###.#.#######.#.###.#
#...#.#...#.#.#.#...#.....#...#.#...#.#.#.#.............#.#...#.#.#...#...#.....#
###.#.###.###.#.###.#####.#####.#.###.#.#.#######.#######.#.###.#.#.#.#.###.#####
#.#.#...#.#...#.#.#.#...#.#.....#.#...#.#...#...#.........#...#...#.#.#.#...#...#
#.#.###.#.#.#.#.#.#.#.#.#.#.#.###.#.###.###.#.#.#############.#####.###.###.###.#
#.#.#...#...#.#...#...#.....#.#...#.....#.#...#.#.........#...#...#...#...#...#.#
#.#.#.###########.###########.#.###.#####.#####.#####.#.#.#.#.#.#.###.###.###.#.#
#...#.#.........#.#.#...#.....#...#.....#.....#.....#.#.#...#...#.......#.#.....#
#.###.#.#######.#.#.#.#.#######.#.#####.#.#.#######.#.#.###############.#.#####.#
#.#...#.#.....#...#.#.#.......#.#.....#.#.#.......#.#.#.#.....#.........#.....#.#
#.#.#.#.#####.#####.#########.#######.#.#.#######.#.###.#.###############.###.#.#
#.#.#.#.#.....#.......#...#...#.....#.#.#.#.....#.......#.#.....#.......#...#.#.#
#.#.###.#.###.#####.#.#.#.#.###.###.#.###.#.###.#.#######.#.###.#.#####.#####.#.#
#.#...#.#...#.......#.#.#.#.....#...#...#.#.#.#.#...#...#...#...#.#.#...#...#.#.#
#.###.#.###.#.#######.#.#.#######.#####.#.#.#.#.###.#.#.#####.###.#.#.###.#.#.#.#
#...#.#...#.#.#...#.....#...#...#.......#.#.#.#...#.#.#.....#...#.#.#...#.#...#.#
#.###.###.#.#.#.#.#########.###.###########.#.###.###.#####.###.#.#.###.#.#####.#
#.#.....#.#.#.#.#...#.............#.....#...#...#.....#...#...#...#.#...#.....#.#
#.#.###.#.#.###.###.#############.###.#.#.#####.#######.###.#######.#.#######.###
#.#.#...#.#.......#.#.....#.....#.....#.#.......#.....#...#.#.......#.#.....#...#
#.#.#####.#.#######.#.###.#.###.#.#############.###.#.###.#.#.#.#####.#.###.###.#
#.#.#...#.#.#.....#...#.#.....#.#.#.....#.....#...#.#...#.#...#.......#.#.......#
#.#.#.#.#.###.###.###.#.#######.###.###.#.#######.#.###.#.#############.#######.#
#.#...#.#.....#.#...#.....#...#.......#.#.#.....#...#.#.#.........#.......#.....#
#.#####.#######.###.###.###.#.#########.#.#.#.#######.#.###.#####.#######.#######
#.....#.......#.....#...#...#.........#.#.#.#.#.......#.....#...#.#.....#.......#
#####.#####.###.#########.###########.#.#.#.#.#.###.#########.###.#.###.#######.#
#.........#...............#.................#.....#.................#...........#
#######################################...#######################################
#.....#...........#.......#.....#.............#.....#.......#.............#.....#
#.#.###.###.#####.#.#####.#.###.#.#.###.#.###.#.#.#.###.###.#.#######.###.#.#.#.#
#.#.......#...#.#...#...#...#...#.#...#.#...#.#.#.#.....#.#.#...#...#.#.#.#.#.#.#
#############.#.#####.#######.###.###.#.#.#.###.#.#######.#.#####.#.#.#.#.###.###
#.......#.....#.....#.......#...#.#...#.#.#.....#.#.......#.....#.#...#.....#...#
#.#####.#.#######.#.#.###.#####.###.###.#.#######.#.###########.#.#########.###.#
#...#.#.#.#.....#.#.....#.....#...#.#.#.#.......#.#.#.......#...#.........#.....#
#.#.#.#.#.#.###.#####.#####.#####.#.#.#.#.#######.#.#.#####.#.#######.###.#####.#
#.#.#...#.#.#.#.#...#.#...#.#...#.#.#...#.#.......#.#...#...#.#.....#...#...#...#
#.#.#.###.#.#.#.#.#.###.#.#.#.#.#.#.#######.#######.###.#.###.###.#.#######.#####
#.#.#.....#...#.#.#...#.#.#...#.#.#.#...#...#.........#.#.........#.......#.....#
#.#.#.#######.#.#.###.#.#.#####.#.#.#.#.#.#######.###.#.#################.#####.#
#.#.#.#...#...#.#...#...#...#...#.#...#.#.......#...#.........#.....#.......#...#
#.#.###.#.#.###.###.#######.#.###.#.###.#######.#############.#.###.#######.#.#.#
#.#...#.#.#.#.#...#.#.....#.#.#...#.#...#.......#.....#.#.....#.#.#.......#.#.#.#
#.###.#.#.#.#.###.#.#.#####.#.#.###.#.###.#######.###.#.#.#####.#.#######.#.#.#.#
#...#.#.#...#...#.....#.....#...#...#...#.......#.#...#...#...#.#.....#...#...#.#
###.#.#.#####.#.#######.#####.###.#####.#######.#.#.###.###.#.#.#####.#.#######.#
#...#.#.......#.....#...#...#...#.#...#.#.....#.#.#...#...#.#...#.....#...#.....#
#.###.#############.#.###.#.###.###.#.#.#.###.#.#.###.#####.#####.#######.###.###
#...#.....#.......#.#.#...#.#...#...#.#.#.#.....#...#.#...#...#.........#...#...#
#######.#.#.#####.#.#####.#.###.#.###.#.#.#########.#.#.#.#####.#####.#.###.#####
#.....#.#.#...#.#...#.....#...#...#...#.#...........#...#.....#.#...#.#...#.....#
#.###.#.#####.#.#####.#######.#####.###.#.###################.#.#.#.#.#.#######.#
#...#.#.....#.....#.#...#.....#...#.#...#.#...........#...#.#...#.#...#.#.......#
###.#.###.#.#####.#.#.#.#.#####.#.#.###.#.###.#######.#.#.#.#####.#####.#.#######
#...#.....#.....#.#...#.#.#...#.#...#...#.#...#.....#.#.#.#...#.#.....#.#.#.....#
#.#############.#.#####.#.###.#.#####.#.#.#.###.#####.#.#.#.#.#.#####.###.#.#.#.#
#.#...........#.#...#...#...#.#.#.....#.#...#.#...#...#.#...#...#...#...#.#.#.#.#
#.###.#########.###.#.#####.#.#.#.###.#.#####.#.#.#.###.#######.#.#####.#.###.#.#
#...#.............#...#...#.#.#.#.#...#.#.....#.#...#...#.#.....#.....#.#.....#.#
###.#.###########.#####.#.#.#.#.###.###.#.#.###.#####.#.#.#.#####.#.#.#.#######.#
#...#.#.........#.....#.#...#.#.#...#...#.#...#.#...#.#.#...#...#.#.#.#.#.....#.#
#.#####.#######.#######.#####.#.#.###.###.###.#.#.#.###.#.###.#.###.#.#.#.#.###.#
#.....#...#...#...#...#.#...#...#.#...#.#...#.#...#.....#.#...#.....#.#...#...#.#
#.###.###.#.#.###.#.#.#.#.###.###.#.###.###.#.###########.#.#########.#######.#.#
#.#.#...#.#.#...#.#.#.#.#...#.#...#.#...#...#.......#.....#.#.......#...#.....#.#
#.#.###.#.#.###.#.#.#.#.#.#.#.###.#.#.#.#.#####.#####.#####.#.#####.###.#.#####.#
#.....#.....#...#...#...#.#.......#...#.#.....#.............#.....#.....#.......#
#################################################################################
